#######################
#.....................#
#.....#....#....#.....#
#####.#### # ####.#####
#####.#    G    #.#####
#####.###########.#####
#..........#..........#
#.########.#.########.#
#..........P..........#
#######################